0,1,2,3,4,5
1,{{flagIOC2|CHN|2014 Asian Games}},27,17,6,50
2,{{flagIOC2|KOR|2014 Asian Games}},8,11,8,27
3,{{flagIOC2|KAZ|2014 Asian Games}},2,0,5,7
4,{{flagIOC2|QAT|2014 Asian Games}},2,0,1,3
5,{{flagIOC2|KUW|2014 Asian Games}},1,4,1,6
6,{{flagIOC2|PRK|2014 Asian Games}},1,3,1,5
7,{{flagIOC2|IRI|2014 Asian Games}},1,2,0,3
8,{{flagIOC2|IND|2014 Asian Games}},1,1,7,9
9,{{flagIOC2|MGL|2014 Asian Games}},1,0,2,3
10,{{flagIOC2|VIE|2014 Asian Games}},0,2,5,7
11,{{flagIOC2|MAS|2014 Asian Games}},0,2,1,3
12,{{flagIOC2|JPN|2014 Asian Games}},0,1,1,2
13,{{flagIOC2|TPE|2014 Asian Games}},0,1,0,1
14,{{flagIOC2|THA|2014 Asian Games}},0,0,3,3
15,{{flagIOC2|SGP|2014 Asian Games}},0,0,2,2
16,{{flagIOC2|UAE|2014 Asian Games}},0,0,1,1
Total,Total,44,44,44,132
